111111111111111111111111111111
1100000000000000C11110000000E1
110000000000000001111000000001
1P000000111100000011C000000001
1100000011111C000011000000N111
1111110011111110N001N000011111
111111000C11110000010001111111
1111C0000000110000010001111111
1100000000000000000N000000C111
11N00000000C111111000000N00111
11C0000000N11111111C0000001111
111111111111111111111111111111
