11111111111111111111111111111111111111
1100000000000000000000C1111000000000E1
1100000000000000N000000111100000000001
1P000000000000111100000011C00000000001
1100000000000011111C00001100000000N111
11111111110000111111100001000000011111
11111111111000111111110001000001111111
11111111111000111111100N01000011111111
111111100000000C1111000001000011111111
1111C000000000000011000001000001111111
11000000000000000000N0000000000000C111
1100N000000000000C111111N0000000N00111
11C0000000N00000011111111C000000001111
11111111111111111111111111111111111111
